1111111111111111
100E000100P00001
100010C000000001
100D000000000001
1000110000011111
1000000000C00001
100000E001111001
1111111111111111
