111111111111111111111
110000000000000000011
110100100101111001011
110100100100001000011
1100P011110111101C001
1100C0000101000E00011
110000000101111000011
110000000000000000011
111111111111111111111