1111111111111111
100E000000P00001
100000C000000001
1111111111111111
